1111111111111111111
1C01E110010000111C1
1101000010011000001
1P00011010101011111
111C11C0001010000C1
1111111111111111111