1111111111111111111111111111111111
1E0000000000000C00000C000000000001
1010010100100000101001000000010101
1010010100100000101001000000010101
1010010100100000101001000000010101
10100101001000001010010000000101C1
1010010100100000101001000000010101
1P0000000C01C000000000000000000001
1111111111111111111111111111111111