1111111111111111111111111111111111
1E00001C00001000C10000C00000000001
101001010010000010100100000C110101
1010010001010100010010000000101011
1P0000000C00C00000000C0001000000C1
1111111111111111111111111111111111